1111111111
1000000001
1020000001
1000111001
1120144001
1020144501
1000100001
1020000001
1000000001
1111111111
1111111111
1000000001
1020000001
1000111111
1020154001
1020144001
1000100001
1020000001
1000000001
1111111111
1111111111
1000004001
1000000001
1000111111
1000150001
1020000001
1000100001
1020104001
1000110001
1111111111